xxxxxxxxxxxxxxx
x1       x    x
x        x    x 
xxxxxxx  x    x
x     x      xx
x     x       x
xx   xxxx  xxxx
x    x     x  x
x             x
xxxxx     xxxxx
x2            x
xxxxxxxxxxxxxxx
