xxxxxxxxxxxxxxx
x  x  1   x  2x
x   x  x  x  xx
x   x  x  x   x 
x   x  x  x   x
x    x    xx  x
x    x   x    x
x        x  xxx
x  x  x  x    x
x   xxx  xxx  x
x  xx    x    x
x   x   xxxx  x
xxxxxxxxxxxxxxx



